year,rank,country,gold,silver,bronze,total
2024,1.0,United States,40,44,42,126
1904,1.0,United States,77,79,78,234
1988,1.0,Soviet Union,55,31,46,132
1908,1.0,Great Britain (GBR)[a],56,51,39,146
1948,1.0,United States,38,27,19,84
1984,1.0,United States,83,61,30,174
2020,1.0,United States,39,41,33,113
1900,1.0,France,31,41,40,112
1920,1.0,United States,41,27,27,95
1924,1.0,United States,45,27,27,99
2016,1.0,United States,46,37,38,121
1980,1.0,Soviet Union,80,69,46,195
1996,1.0,United States,44,32,25,101
1912,1.0,United States,26,19,19,64
1976,1.0,Soviet Union,49,41,35,125
1952,1.0,United States,40,19,17,76
1972,1.0,Soviet Union,50,27,22,99
1964,1.0,United States,36,26,28,90
1932,1.0,United States (USA),44,36,30,110
1960,1.0,Soviet Union (URS),43,29,31,103
1896,1.0,United States,11,7,2,20
1936,1.0,Germany,38,31,32,101
1992,1.0,Unified Team,45,38,29,112
1956,1.0,Soviet Union,37,29,32,98
2004,1.0,United States,36,39,26,101
1968,1.0,United States,45,28,34,107
2012,1.0,United States,48,26,31,105
1928,1.0,United States,22,18,16,56
2008,1.0,China,48,22,30,100
2000,1.0,United States,37,24,32,93
1952,2.0,Soviet Union,22,30,19,71
1996,2.0,Russia,26,21,16,63
1964,2.0,Soviet Union,30,31,35,96
2004,2.0,China,32,17,14,63
1932,2.0,Italy (ITA),12,12,12,36
1980,2.0,East Germany,47,37,42,126
2016,2.0,Great Britain,27,23,17,67
2000,2.0,Russia,32,28,29,89
1968,2.0,Soviet Union,29,32,30,91
2012,2.0,China,39,31,22,92
1992,2.0,United States,37,34,37,108
1896,2.0,Greece,10,18,19,47
1900,2.0,United States,20,13,15,48
1960,2.0,United States (USA),34,21,16,71
1928,2.0,Germany,10,7,14,31
1956,2.0,United States,32,25,17,74
1936,2.0,United States,24,21,12,57
1904,2.0,Germany,4,5,6,15
1908,2.0,United States (USA),23,12,12,47
1912,2.0,Sweden,23,25,17,65
2008,2.0,United States,36,39,37,112
1984,2.0,Romania,20,16,17,53
1972,2.0,United States,33,31,30,94
1920,2.0,Sweden,19,20,25,64
1924,2.0,Finland,14,13,10,37
1976,2.0,East Germany,40,25,25,90
2020,2.0,China,38,32,19,89
1948,2.0,Sweden,17,11,18,46
1988,2.0,East Germany,37,35,30,102
2024,2.0,China,40,27,24,91
1912,3.0,Great Britain,10,15,16,41
1988,3.0,United States,36,31,27,94
2024,3.0,Japan,20,12,13,45
1908,3.0,Sweden (SWE),8,6,11,25
1968,3.0,Japan,11,7,7,25
2016,3.0,China,26,18,26,70
1956,3.0,Australia,13,8,14,35
2000,3.0,China,28,16,14,58
1948,3.0,France,11,6,15,32
2008,3.0,Russia,24,13,23,60
2020,3.0,Japan,27,14,17,58
1976,3.0,United States,34,35,25,94
1924,3.0,France,13,15,10,38
1920,3.0,Finland,15,10,9,34
1972,3.0,East Germany,20,23,23,66
1984,3.0,West Germany,17,19,23,59
1952,3.0,Hungary,16,10,16,42
1980,3.0,Bulgaria,8,16,17,41
1996,3.0,Germany,20,18,27,65
1904,3.0,Canada,4,1,1,6
1928,3.0,Finland,8,8,9,25
1932,3.0,France (FRA),11,5,4,20
2004,3.0,Russia,28,26,36,90
1964,3.0,Japan,16,5,8,29
1936,3.0,Hungary,10,1,5,16
1896,3.0,Germany,6,5,2,13
1900,3.0,Great Britain,20,8,9,37
2012,3.0,Great Britain,29,18,18,65
1992,3.0,Germany,33,21,28,82
1960,3.0,Italy (ITA),13,10,13,36
1904,4.0,Cuba,3,0,0,3
1992,4.0,China,16,22,16,54
1960,4.0,United Team of Germany (EUA),12,19,11,42
1936,4.0,Italy,9,13,5,27
1896,4.0,France,5,4,2,11
2004,4.0,Australia,17,16,17,50
1984,4.0,China,15,8,9,32
1952,4.0,Sweden,12,13,10,35
1980,4.0,Cuba,8,7,5,20
1972,4.0,West Germany,13,11,16,40
1920,4.0,Great Britain,14,15,13,42
1924,4.0,Great Britain,9,13,12,34
2012,4.0,Russia,18,20,26,64
1956,4.0,Hungary,9,10,7,26
1900,4.0,Belgium,6,6,6,18
1968,4.0,Hungary,10,10,12,32
1928,4.0,Sweden,7,6,12,25
2000,4.0,Australia,16,25,17,58
1932,4.0,Sweden (SWE),10,5,9,24
1964,4.0,United Team of Germany[A],10,22,18,50
2016,4.0,Russia,19,17,20,56
1996,4.0,China,16,22,12,50
1988,4.0,South Korea,12,10,11,33
1912,4.0,Finland,9,8,9,26
2020,4.0,Great Britain,22,20,22,64
1948,4.0,Finland,10,8,6,24
1908,4.0,France (FRA),5,5,9,19
2024,4.0,Australia,18,19,16,53
1976,4.0,West Germany,10,12,17,39
2008,4.0,Great Britain,19,13,19,51
1920,5.0,Belgium,14,11,11,36
1976,5.0,Japan,9,6,10,25
1972,5.0,Japan,13,8,8,29
1952,5.0,Italy,8,9,4,21
1980,5.0,Italy,8,3,4,15
1984,5.0,Italy,14,6,12,32
1988,5.0,West Germany,11,14,15,40
2024,5.0,France,16,26,22,64
1968,5.0,East Germany,9,9,7,25
1904,5.0,Hungary,2,1,1,4
1936,5.0,Finland,8,6,6,20
1956,5.0,Italy,8,8,9,25
1960,5.0,Australia (AUS),8,8,6,22
1900,5.0,Switzerland,6,3,1,10
1992,5.0,Cuba,14,6,11,31
2012,5.0,South Korea,13,9,9,31
1896,5.0,Great Britain,2,3,2,7
1996,5.0,France,15,7,15,37
1932,5.0,Japan (JPN),7,7,4,18
1964,5.0,Italy,10,10,7,27
2000,5.0,Germany,13,17,26,56
2016,5.0,Germany,17,10,15,42
2004,5.0,Japan,16,9,12,37
1928,5.0,Italy,7,5,7,19
1924,5.0,Italy,8,3,5,16
2020,5.0,ROC,20,28,23,71
1912,5.0,France,7,5,3,15
2008,5.0,Germany,16,11,14,41
1908,5.0,Germany (GER)[a],3,5,5,13
1948,5.0,Hungary,10,5,13,28
1932,6.0,Hungary (HUN),6,5,5,16
2004,6.0,Germany,13,16,20,49
2016,6.0,Japan,12,8,21,41
1956,6.0,Sweden,8,5,6,19
1904,6.0,Norway,2,0,0,2
1960,6.0,Turkey (TUR),7,2,0,9
1896,6.0,Hungary,2,1,3,6
1936,6.0,France,7,6,6,19
2012,6.0,Germany,11,20,13,44
1900,6.0,Germany,4,3,2,9
1980,6.0,Hungary,7,10,15,32
1952,6.0,Czechoslovakia,7,3,3,13
1996,6.0,Italy,13,10,12,35
1976,6.0,Poland,7,6,13,26
1972,6.0,Australia,8,7,2,17
1924,6.0,Switzerland,7,8,10,25
2000,6.0,France,13,14,11,38
2008,6.0,Australia,14,15,17,46
1988,6.0,Hungary,11,6,6,23
1948,6.0,Italy,9,12,10,31
2024,6.0,Netherlands,15,7,12,34
1992,6.0,Spain,13,7,2,22
1908,6.0,Hungary (HUN),3,4,2,9
1912,6.0,Germany,6,13,7,26
2020,6.0,Australia,17,7,22,46
1920,6.0,Norway,13,9,9,31
1964,6.0,Hungary,10,7,5,22
1928,6.0,Switzerland,7,4,4,15
1984,6.0,Canada,10,18,16,44
1968,6.0,France,7,3,5,15
1952,7.0,France,6,6,6,18
1992,7.0,South Korea,12,5,12,29
1908,7.0,Canada (CAN),3,3,10,16
1972,7.0,Poland,7,5,9,21
1924,7.0,Norway,5,2,3,10
1980,7.0,Romania,6,6,13,25
1984,7.0,Japan,10,8,14,32
1996,7.0,Australia,9,9,23,41
1920,7.0,Italy,13,5,5,23
1976,7.0,Bulgaria,6,9,7,22
2000,7.0,Italy,13,8,13,34
1948,7.0,Turkey,6,4,2,12
1896,7.0,Austria,2,1,2,5
1900,7.0,Italy,3,2,0,5
2020,7.0,Netherlands,10,12,14,36
1912,7.0,Italy,5,1,2,8
1988,7.0,Bulgaria,10,12,13,35
2024,7.0,Great Britain,14,22,29,65
1960,7.0,Hungary (HUN),6,8,7,21
1904,7.0,Austria,1,1,1,3
1936,7.0,Sweden,6,5,10,21
1928,7.0,France,6,10,5,21
2016,7.0,France,10,18,14,42
2012,7.0,France,11,11,13,35
1968,7.0,Czechoslovakia,7,2,4,13
1932,7.0,Germany (GER),5,12,7,24
2004,7.0,France,11,9,13,33
1964,7.0,Poland,7,6,10,23
2008,7.0,South Korea,13,11,8,32
1956,7.0,United Team of Germany[e],6,13,7,26
1976,8.0,Cuba,6,4,3,13
1980,8.0,France,6,5,3,14
1920,8.0,France,9,19,13,41
1956,8.0,Great Britain,6,7,11,24
1996,8.0,Cuba,9,8,8,25
1896,8.0,Australia,2,0,0,2
1948,8.0,Czechoslovakia,6,2,3,11
1952,8.0,Finland,6,3,13,22
2024,8.0,South Korea,13,9,10,32
1908,8.0,Norway (NOR),2,3,3,8
1912,8.0,South Africa,4,2,0,6
1988,8.0,Romania,7,11,6,24
1984,8.0,New Zealand,8,1,2,11
2020,8.0,France,10,12,11,33
2000,8.0,Netherlands,12,9,4,25
1924,8.0,Sweden,4,13,12,29
1932,8.0,Finland (FIN),5,8,12,25
2004,8.0,Italy,10,11,11,32
1964,8.0,Australia,6,2,10,18
2008,8.0,Japan,9,8,8,25
2012,8.0,Australia,8,15,12,35
2016,8.0,South Korea,9,3,9,21
1928,8.0,Netherlands,6,9,4,19
1968,8.0,West Germany,5,11,10,26
1972,8.0,Hungary,6,13,16,35
1960,8.0,Japan (JPN),4,7,7,18
1992,8.0,Hungary,11,12,7,30
1904,8.0,Great Britain,1,1,0,2
1936,8.0,Japan,6,4,10,20
1900,8.0,Denmark,1,3,2,6
1900,9.0,Netherlands,1,2,3,6
1900,9.0,Mixed team,1,2,3,6
1992,9.0,France,8,5,16,29
1904,9.0,Switzerland,1,0,2,3
1960,9.0,Poland (POL),4,6,11,21
1936,9.0,Netherlands,6,4,7,17
2004,9.0,South Korea,9,12,9,30
1932,9.0,Great Britain (GBR),5,7,5,17
1968,9.0,Australia,5,7,5,17
1964,9.0,Czechoslovakia,5,6,3,14
1924,9.0,Netherlands,4,1,5,10
2000,9.0,Cuba,11,11,7,29
2008,9.0,Italy,8,9,10,27
2012,9.0,Italy,8,9,11,28
2016,9.0,Italy,8,12,8,28
1972,9.0,Bulgaria,6,10,5,21
1928,9.0,Hungary,4,5,0,9
1984,9.0,Yugoslavia,7,4,7,18
1912,9.0,Norway,3,2,5,10
1908,9.0,Italy (ITA),2,2,0,4
1896,9.0,Denmark,1,2,3,6
2024,9.0,Italy,12,13,15,40
1948,9.0,Switzerland,5,12,6,23
1952,9.0,Australia,6,2,3,11
1956,9.0,Romania,5,3,5,13
1920,9.0,Netherlands,4,2,5,11
1988,9.0,France,6,4,6,16
2020,9.0,Germany,10,11,16,37
1996,9.0,Ukraine,9,2,12,23
1976,9.0,Romania,4,9,14,27
1980,9.0,Great Britain,5,7,9,21
1964,10.0,Great Britain,4,12,2,18
1976,10.0,Hungary,4,5,13,22
1924,10.0,Belgium,3,7,3,13
1928,10.0,Canada,4,4,7,15
2000,10.0,Great Britain,11,10,7,28
1936,10.0,Austria,5,7,5,17
1972,10.0,Italy,5,3,10,18
2008,10.0,France,7,16,20,43
2012,10.0,Hungary,8,4,6,18
2016,10.0,Australia,8,11,10,29
1932,10.0,Poland (POL),3,2,4,9
1960,10.0,Czechoslovakia (TCH),3,2,3,8
1992,10.0,Australia,7,9,11,27
2004,10.0,Great Britain,9,9,12,30
1968,10.0,Great Britain,5,5,3,13
1956,10.0,Japan,4,10,5,19
1920,10.0,Denmark,3,9,1,13
1912,10.0,Hungary,3,2,3,8
1988,10.0,Italy,6,4,4,14
1984,10.0,South Korea,6,6,7,19
2020,10.0,Italy,10,10,20,40
1996,10.0,South Korea,7,15,5,27
1980,10.0,Poland,3,14,15,32
1908,10.0,Belgium (BEL),1,5,2,8
1912,10.0,Canada,3,2,3,8
1952,10.0,Norway,3,2,0,5
1948,10.0,Denmark,5,8,9,22
2024,10.0,Germany,12,13,8,33
1904,10.0,Greece,1,0,1,2
1896,10.0,Switzerland,1,2,0,3
1896,11.0,Mixed team,1,0,1,2
1948,11.0,Netherlands,5,2,9,16
1904,11.0,Mixed team,1,0,0,1
1992,11.0,Canada,7,4,7,18
1988,11.0,China,5,11,12,28
1908,11.0,Australasia (ANZ),1,2,2,5
1956,11.0,France,4,4,6,14
1936,11.0,Switzerland,4,9,5,18
2008,11.0,Netherlands,7,5,4,16
1996,11.0,Poland,7,5,5,17
1920,11.0,South Africa,3,4,3,10
2012,11.0,Japan,7,14,17,38
2020,11.0,Canada,7,7,10,24
1984,11.0,Great Britain,5,11,21,37
1952,11.0,Switzerland,2,6,6,14
1980,11.0,Sweden,3,3,6,12
2000,11.0,Romania,11,6,9,26
1960,11.0,Romania (ROU),3,1,6,10
1932,11.0,Australia (AUS),3,1,1,5
1968,11.0,Poland,5,2,11,18
1972,11.0,Sweden,4,6,6,16
1964,11.0,Bulgaria,3,5,2,10
2016,11.0,Netherlands,8,7,4,19
1928,11.0,Great Britain,3,10,7,20
1976,11.0,Finland,4,2,0,6
1924,11.0,Australia,3,1,2,6
2004,11.0,Cuba,9,7,11,27
1900,11.0,Hungary,1,2,2,5
2024,11.0,New Zealand,10,7,3,20
1956,12.0,Turkey,3,2,2,7
1984,12.0,France,5,7,16,28
2008,12.0,Ukraine,7,4,11,22
1980,12.0,Finland,3,1,4,8
1924,12.0,Denmark,2,5,2,9
1964,12.0,New Zealand,3,0,2,5
1976,12.0,Sweden,4,1,0,5
1996,12.0,Hungary,7,4,10,21
1936,12.0,Great Britain,4,7,3,14
1920,12.0,Canada,3,3,3,9
1948,12.0,Great Britain,4,16,7,27
1928,12.0,Argentina,3,3,1,7
2016,12.0,Hungary,8,3,4,15
1972,12.0,Great Britain,4,5,9,18
2000,12.0,South Korea,8,10,10,28
1932,12.0,Argentina (ARG),3,1,0,4
1968,12.0,Romania,4,6,5,15
1960,12.0,Great Britain (GBR),2,6,12,20
1964,12.0,Finland,3,0,2,5
1992,12.0,Italy,6,5,8,19
1912,12.0,Australasia,2,2,3,7
1908,12.0,Russian Empire,1,2,0,3
1952,12.0,South Africa,2,4,4,10
2004,12.0,Hungary,8,6,3,17
2020,12.0,Brazil,7,6,8,21
2012,12.0,Iran,7,5,1,13
1988,12.0,Great Britain,5,10,9,24
2024,12.0,Canada,9,7,11,27
1900,12.0,Cuba,1,1,0,2
1904,12.0,Australia,0,3,1,4
1936,13.0,Czechoslovakia,3,5,1,9
2020,13.0,New Zealand,7,6,7,20
1988,13.0,Kenya,5,2,2,9
1908,13.0,Finland (FIN),1,1,3,5
1912,13.0,Belgium,2,1,3,6
2000,13.0,Hungary,8,6,3,17
1968,13.0,Italy,3,4,9,16
1928,13.0,Denmark,3,1,2,6
2016,13.0,Brazil,7,6,6,19
1932,13.0,Canada (CAN),2,5,9,16
1920,13.0,Switzerland,2,2,7,11
1996,13.0,Spain,5,6,6,17
1980,13.0,Czechoslovakia,2,3,9,14
1924,13.0,Hungary,2,3,4,9
1972,13.0,Romania,3,6,7,16
1960,13.0,Denmark (DEN),2,3,1,6
1976,13.0,Great Britain,3,5,5,13
2008,13.0,Kenya,6,4,6,16
1992,13.0,Great Britain,5,3,12,20
1948,13.0,Argentina,3,3,1,7
1900,13.0,Spain,1,0,0,1
2004,13.0,Ukraine,8,5,9,22
1984,13.0,Netherlands,5,2,6,13
2012,13.0,Netherlands,6,6,8,20
1956,13.0,Finland,3,1,11,15
1952,13.0,Jamaica,2,3,0,5
2024,13.0,Uzbekistan,8,2,3,13
1904,13.0,France,0,1,0,1
1900,14.0,Austria,0,3,3,6
1908,14.0,South Africa (RSA),1,1,0,2
1912,14.0,Denmark,1,6,5,12
2012,14.0,New Zealand,6,2,5,13
1988,14.0,Japan,4,3,7,14
1948,14.0,Australia,2,6,5,13
1972,14.0,Finland,3,1,4,8
2000,14.0,Poland,6,5,3,14
1972,14.0,Cuba,3,1,4,8
1968,14.0,Kenya,3,4,2,9
2016,14.0,Spain,7,4,6,17
1932,14.0,Netherlands (NED),2,5,1,8
1928,14.0,Czechoslovakia,2,5,2,9
1964,14.0,Romania,2,4,6,12
1924,14.0,Yugoslavia,2,0,0,2
1960,14.0,New Zealand (NZL),2,0,1,3
1976,14.0,Italy,2,7,4,13
2008,14.0,Spain,5,11,3,19
1920,14.0,Estonia,1,2,0,3
1996,14.0,Romania,4,7,9,20
1984,14.0,Australia,4,8,12,24
2020,14.0,Cuba,7,3,5,15
1956,14.0,Iran,2,2,1,5
1936,14.0,Estonia,2,2,3,7
1936,14.0,Argentina,2,2,3,7
1980,14.0,Yugoslavia,2,3,4,9
2004,14.0,Romania,8,5,6,19
1952,14.0,Belgium,2,2,0,4
1992,14.0,Romania,4,6,8,18
2024,14.0,Hungary,6,7,6,19
2020,15.0,Hungary,6,7,7,20
1984,15.0,Finland,4,2,6,12
1956,15.0,Canada,2,1,3,6
1920,15.0,Brazil,1,1,1,3
1992,15.0,Czechoslovakia,4,2,1,7
1908,15.0,Greece (GRE)[b],0,3,1,4
1948,15.0,Belgium,2,2,3,7
2012,15.0,Ukraine,5,4,10,19
1952,15.0,Denmark,2,1,3,6
1912,15.0,Greece,1,0,1,2
1988,15.0,Australia,3,6,5,14
1968,15.0,Mexico,3,3,3,9
2016,15.0,Kenya,6,6,1,13
1932,15.0,South Africa (RSA),2,0,3,5
1928,15.0,Japan,2,2,1,5
2000,15.0,Japan,5,8,5,18
1924,15.0,Czechoslovakia,1,4,5,10
1964,15.0,Netherlands,2,4,4,10
1960,15.0,Bulgaria (BUL),1,3,3,7
1976,15.0,France,2,3,4,9
1980,15.0,Australia,2,2,5,9
1996,15.0,Netherlands,4,5,10,19
2008,15.0,Jamaica,5,4,2,11
1900,15.0,Norway,0,2,3,5
2004,15.0,Greece,6,6,4,16
2024,15.0,Spain,5,4,9,18
2024,16.0,Sweden,4,4,3,11
1968,16.0,Yugoslavia,3,3,2,8
1932,16.0,Ireland (IRL),2,0,0,2
1952,16.0,Turkey,2,0,1,3
1988,16.0,Yugoslavia,3,4,5,12
1912,16.0,Switzerland,1,0,0,1
1992,16.0,North Korea,4,0,5,9
1964,16.0,Turkey,2,3,1,6
2016,16.0,Jamaica,6,3,2,11
1928,16.0,Estonia,2,1,2,5
1936,16.0,Egypt,2,1,2,5
1960,16.0,Sweden (SWE),1,2,3,6
1972,16.0,Netherlands,3,1,1,5
2000,16.0,Bulgaria,5,6,2,13
2012,16.0,Cuba,5,3,7,15
2020,16.0,South Korea,6,4,10,20
1924,16.0,Argentina,1,3,2,6
1984,16.0,Sweden,2,11,6,19
1920,16.0,Australia,0,2,1,3
1976,16.0,Yugoslavia,2,3,3,8
1956,16.0,New Zealand,2,0,0,2
1900,16.0,India,0,2,0,2
2008,16.0,Poland,4,5,2,11
1980,16.0,Denmark,2,1,2,5
1996,16.0,Greece,4,4,0,8
1908,16.0,Denmark (DEN),0,2,3,5
1948,16.0,South Africa,2,2,2,6
2004,16.0,Brazil,5,2,3,10
1932,17.0,Czechoslovakia (TCH),1,3,2,6
1936,17.0,Canada,1,3,5,9
1900,17.0,Bohemia,0,1,1,2
2016,17.0,Croatia,5,3,2,10
2020,17.0,Poland,4,5,5,14
1956,17.0,Poland,1,4,4,9
2000,17.0,Greece,4,6,3,13
1960,17.0,Finland (FIN),1,1,3,5
1972,17.0,France,2,4,7,13
1976,17.0,Czechoslovakia,2,2,4,8
1928,17.0,Egypt,2,1,1,4
1924,17.0,Estonia,1,1,4,6
1920,17.0,Spain,0,2,0,2
1920,17.0,Japan,0,2,0,2
1984,17.0,Mexico,2,3,1,6
1992,17.0,Japan,3,8,11,22
1968,17.0,Netherlands,3,3,1,7
2012,17.0,Spain,4,10,6,20
1988,17.0,Czechoslovakia,3,3,2,8
2024,17.0,Kenya,4,2,5,11
1980,17.0,Brazil,2,0,2,4
1948,17.0,Egypt,2,2,1,5
1908,17.0,Netherlands (NED),0,0,2,2
1908,17.0,Bohemia (BOH),0,0,2,2
1996,17.0,Czech Republic,4,3,4,11
2004,17.0,Norway,5,0,1,6
1952,17.0,Japan,1,6,2,9
2008,17.0,Ethiopia,4,2,1,7
1980,17.0,Ethiopia,2,0,2,4
1964,17.0,Sweden,2,2,4,8
1912,17.0,Russian Empire,0,2,3,5
1960,18.0,Yugoslavia (YUG),1,1,0,2
1984,18.0,Morocco,2,0,0,2
1960,18.0,Austria (AUT),1,1,0,2
1996,18.0,Switzerland,4,3,0,7
1976,18.0,New Zealand,2,1,1,4
1932,18.0,Austria (AUT),1,1,3,5
1936,18.0,Norway,1,3,2,6
1972,18.0,Czechoslovakia,2,4,2,8
2020,18.0,Czech Republic,4,4,3,11
2000,18.0,Sweden,4,5,3,12
1924,18.0,South Africa,1,1,1,3
1956,18.0,Czechoslovakia,1,4,1,6
1928,18.0,Austria,2,0,1,3
1988,18.0,New Zealand,3,2,8,13
2012,18.0,Jamaica,4,5,4,13
1992,18.0,Bulgaria,3,7,6,16
1912,18.0,Austria,0,2,2,4
1948,18.0,Mexico,2,1,2,5
2004,18.0,Netherlands,4,9,9,22
2008,18.0,Romania,4,1,4,9
1952,18.0,Great Britain,1,2,8,11
2016,18.0,Cuba,5,2,4,11
1968,18.0,Bulgaria,2,4,3,9
2024,18.0,Norway,4,1,3,8
1964,18.0,Denmark,2,1,3,6
1900,18.0,Australia,0,0,3,3
1920,19.0,Luxembourg,0,1,0,1
1920,19.0,Greece,0,1,0,1
1996,19.0,Turkey,4,1,1,6
1936,19.0,Turkey,1,0,1,2
1956,19.0,Bulgaria,1,3,1,5
1976,19.0,South Korea,1,1,4,6
1928,19.0,Norway,1,2,1,4
1972,19.0,Kenya,2,3,4,9
2000,19.0,Norway,4,3,3,10
1984,19.0,Brazil,1,5,2,8
1996,19.0,Denmark,4,1,1,6
1988,19.0,Canada,3,2,5,10
1968,19.0,Iran,2,1,2,5
1928,19.0,Australia,1,2,1,4
2012,19.0,Czech Republic,4,4,3,11
1900,19.0,Sweden,0,0,1,1
2008,19.0,Cuba,3,10,17,30
1908,19.0,Austria (AUT),0,0,1,1
1948,19.0,Norway,1,3,3,7
1924,19.0,Uruguay,1,0,0,1
1952,19.0,Argentina,1,2,2,5
1980,19.0,Switzerland,2,0,0,2
1912,19.0,Netherlands,0,0,3,3
1932,19.0,India (IND),1,0,0,1
1964,19.0,Yugoslavia,2,1,2,5
2016,19.0,New Zealand,4,9,5,18
2020,19.0,Kenya,4,4,2,10
2004,19.0,Sweden,4,2,1,7
2024,19.0,Ireland,4,0,3,7
1992,19.0,Poland,3,6,10,19
1960,20.0,Pakistan (PAK),1,0,1,2
1956,20.0,Denmark,1,2,1,4
1984,20.0,Spain,1,2,2,5
2008,20.0,Canada,3,9,8,20
2020,20.0,Norway,4,2,2,8
2024,20.0,Brazil,3,7,10,20
1992,20.0,Netherlands,2,6,7,15
2004,20.0,Spain,3,11,6,20
1968,20.0,Sweden,2,1,1,4
1988,20.0,Poland,2,5,9,16
1964,20.0,Belgium,2,0,1,3
2016,20.0,Canada,4,3,15,22
1972,20.0,Yugoslavia,2,1,2,5
1948,20.0,Jamaica,1,2,0,3
2000,20.0,Ethiopia,4,1,3,8
1976,20.0,Switzerland,1,1,2,4
1952,20.0,Poland,1,2,1,4
1924,20.0,Austria,0,3,1,4
1936,20.0,New Zealand,1,0,0,1
1932,20.0,Denmark (DEN),0,5,3,8
2012,20.0,South Africa,4,1,1,6
1936,20.0,India,1,0,0,1
1980,20.0,Spain,1,3,2,6
1924,20.0,Canada,0,3,1,4
1928,21.0,Poland,1,1,3,5
1996,21.0,Canada,3,11,8,22
1960,21.0,Norway (NOR),1,0,0,1
1928,21.0,Yugoslavia,1,1,3,5
1980,21.0,Austria,1,2,1,4
1988,21.0,Norway,2,3,0,5
2004,21.0,Canada,3,6,3,12
2012,21.0,North Korea,4,0,2,6
1968,21.0,Turkey,2,0,0,2
1932,21.0,Mexico (MEX),0,2,0,2
2024,21.0,Iran,3,6,3,12
1960,21.0,Greece (GRE),1,0,0,1
1984,21.0,Belgium,1,1,2,4
1960,21.0,Ethiopia (ETH),1,0,0,1
1956,21.0,Ireland,1,1,3,5
2020,21.0,Jamaica,4,1,4,9
2000,21.0,Ukraine,3,10,10,23
1976,21.0,Jamaica,1,1,0,2
1964,21.0,France,1,8,6,15
2016,21.0,Uzbekistan,4,2,7,13
1972,21.0,Norway,2,1,1,4
2008,21.0,Hungary,3,5,2,10
1992,21.0,Kenya,2,4,2,8
1952,21.0,Yugoslavia,1,2,0,3
1952,21.0,Canada,1,2,0,3
1920,21.0,Czechoslovakia,0,0,2,2
1976,21.0,Norway,1,1,0,2
1976,21.0,North Korea,1,1,0,2
1948,21.0,Austria,1,0,3,4
1992,22.0,Norway,2,4,1,7
1988,22.0,Netherlands,2,2,5,9
1936,22.0,Poland,0,4,5,9
1924,22.0,Poland,0,1,1,2
1980,22.0,Greece,1,0,2,3
2008,22.0,Norway,3,5,1,9
1920,22.0,New Zealand,0,0,1,1
1996,22.0,Bulgaria,3,7,5,15
1964,22.0,Switzerland,1,2,1,4
2000,22.0,Kazakhstan,3,4,0,7
1964,22.0,Canada,1,2,1,4
2020,22.0,Spain,3,8,6,17
1984,22.0,Austria,1,1,1,3
1956,22.0,Norway,1,0,2,3
1972,22.0,North Korea,1,1,3,5
1968,22.0,Denmark,1,4,3,8
1948,22.0,Poland,1,0,1,2
1932,22.0,New Zealand (NZL),0,1,0,1
1932,22.0,Latvia (LAT),0,1,0,1
2012,22.0,Brazil,3,5,9,17
1932,22.0,Switzerland (SUI),0,1,0,1
2016,22.0,Colombia,3,2,3,8
2004,22.0,Turkey,3,3,4,10
2024,22.0,Ukraine,3,5,4,12
1980,23.0,Belgium,1,0,0,1
1924,23.0,Portugal,0,0,1,1
1984,23.0,Portugal,1,0,2,3
1924,23.0,Japan,0,0,1,1
1924,23.0,Romania,0,0,1,1
2020,23.0,Sweden,3,6,0,9
1924,23.0,Haiti,0,0,1,1
1948,23.0,Peru,1,0,0,1
2000,23.0,Belarus,3,3,11,17
1924,23.0,New Zealand,0,0,1,1
2004,23.0,Poland,3,2,5,10
1956,23.0,Mexico,1,0,1,2
2012,23.0,Poland,3,2,6,11
2012,23.0,Kazakhstan,3,2,6,11
1984,23.0,Kenya,1,0,2,3
1996,23.0,Japan,3,6,5,14
1928,23.0,South Africa,1,0,2,3
1980,23.0,Zimbabwe,1,0,0,1
2008,23.0,Brazil,3,4,10,17
1980,23.0,India,1,0,0,1
1952,23.0,Romania,1,1,2,4
1968,23.0,Canada,1,3,1,5
2024,23.0,Romania,3,4,2,9
1992,23.0,Turkey,2,2,2,6
2016,23.0,Switzerland,3,2,2,7
1972,23.0,New Zealand,1,1,1,3
1936,23.0,Denmark,0,2,3,5
1948,23.0,India,1,0,0,1
1988,23.0,Denmark,2,1,1,4
1988,24.0,Brazil,1,2,3,6
1928,24.0,Ireland,1,0,0,1
1928,24.0,New Zealand,1,0,0,1
1964,24.0,India,1,0,0,1
1992,24.0,Indonesia,2,2,1,5
1936,24.0,Latvia,0,1,1,2
1952,24.0,Brazil,1,0,2,3
1976,24.0,Denmark,1,0,2,3
2000,24.0,Canada,3,3,8,14
1928,24.0,Spain,1,0,0,1
1996,24.0,Kazakhstan,3,4,4,11
1928,24.0,India,1,0,0,1
2008,24.0,Belarus,3,4,7,14
1960,24.0,Switzerland (SUI),0,3,3,6
1956,24.0,India,1,0,0,1
2004,24.0,New Zealand,3,2,0,5
1968,24.0,Finland,1,2,1,4
2016,24.0,Iran,3,1,4,8
1972,24.0,Uganda,1,1,0,2
1956,24.0,Brazil,1,0,0,1
1952,24.0,New Zealand,1,0,2,3
2024,24.0,Georgia,3,3,1,7
1964,24.0,Ethiopia,1,0,0,1
1928,24.0,Uruguay,1,0,0,1
1964,24.0,Bahamas,1,0,0,1
2020,24.0,Switzerland,3,4,6,13
2008,25.0,Czech Republic,3,3,1,7
1996,25.0,Brazil,3,3,9,15
1984,25.0,Pakistan,1,0,0,1
2000,25.0,Spain,3,3,5,11
1936,25.0,South Africa,0,1,0,1
1976,25.0,Mexico,1,0,1,2
1960,25.0,France (FRA),0,2,3,5
2020,25.0,Denmark,3,4,4,11
1948,25.0,Canada,0,2,2,4
1936,25.0,Romania,0,1,0,1
2024,25.0,Belgium,3,1,6,10
1936,25.0,Yugoslavia,0,1,0,1
1988,25.0,Finland,1,1,2,4
1992,25.0,Brazil,2,1,0,3
2012,25.0,Ethiopia,3,2,3,8
1972,25.0,Denmark,1,0,0,1
1932,25.0,Philippines (PHI),0,0,3,3
2004,25.0,Thailand,3,1,4,8
1968,25.0,Norway,1,1,0,2
1968,25.0,Ethiopia,1,1,0,2
2016,25.0,Greece,3,1,2,6
1988,25.0,Spain,1,1,2,4
2024,26.0,Bulgaria,3,1,3,7
1952,26.0,India,1,0,1,2
2004,26.0,Belarus,2,5,6,13
1992,26.0,Greece,2,0,0,2
2020,26.0,Croatia,3,3,2,8
1932,26.0,Spain (ESP),0,0,1,1
2012,26.0,Croatia,3,1,2,6
1960,26.0,Belgium (BEL),0,2,2,4
1932,26.0,Belgium (BEL),0,0,1,1
1956,26.0,Yugoslavia,0,3,0,3
1932,26.0,Uruguay (URU),0,0,1,1
1948,26.0,Yugoslavia,0,2,0,2
1984,26.0,Switzerland,0,4,4,8
1996,26.0,New Zealand,3,2,1,6
2016,26.0,Argentina,3,1,0,4
1972,26.0,Switzerland,0,3,0,3
2000,26.0,Turkey,3,0,2,5
1980,26.0,North Korea,0,3,2,5
1976,26.0,Trinidad and Tobago,1,0,0,1
2008,26.0,Slovakia,3,3,0,6
1948,27.0,Portugal,0,1,1,2
1948,27.0,Uruguay,0,1,1,2
1980,27.0,Mongolia,0,2,2,4
1956,27.0,Chile,0,2,2,4
2004,27.0,Austria,2,4,1,7
1968,27.0,New Zealand,1,0,2,3
1988,27.0,Turkey,1,1,0,2
2020,27.0,Iran,3,2,2,7
1964,27.0,South Korea,0,2,1,3
1992,27.0,Sweden,1,7,4,12
1952,27.0,Luxembourg,1,0,0,1
1984,27.0,Denmark,0,3,3,6
2016,27.0,Denmark,2,6,7,15
1960,27.0,Iran (IRI),0,1,3,4
1996,27.0,South Africa,3,1,1,5
1972,27.0,Canada,0,2,3,5
2012,27.0,Canada,2,6,10,18
1976,27.0,Canada,0,5,6,11
2000,27.0,Iran,3,0,1,4
2024,27.0,Serbia,3,1,1,5
2008,27.0,New Zealand,3,2,4,9
1980,28.0,Tanzania,0,2,0,2
2000,28.0,Czech Republic,2,3,3,8
2012,28.0,Belarus,2,5,3,10
1984,28.0,Jamaica,0,1,2,3
1996,28.0,Ireland,3,0,1,4
1976,28.0,Belgium,0,3,3,6
1984,28.0,Norway,0,1,2,3
1960,28.0,South Africa (RSA),0,1,2,3
2004,28.0,Ethiopia,2,3,2,7
1968,28.0,Tunisia,1,0,1,2
2020,28.0,Serbia,3,1,5,9
1960,28.0,Netherlands (NED),0,1,2,3
1956,28.0,Belgium,0,2,0,2
1964,28.0,Trinidad and Tobago,0,1,2,3
1936,28.0,Mexico,0,0,3,3
1936,28.0,Belgium,0,0,3,3
1952,28.0,Germany,0,7,17,24
2024,28.0,Czech Republic,3,0,2,5
1988,28.0,Morocco,1,0,2,3
1992,28.0,New Zealand,1,4,5,10
2008,28.0,Georgia,3,2,2,7
1972,28.0,Iran,0,2,1,3
2016,28.0,Sweden,2,6,3,11
1948,29.0,Spain,0,1,0,1
1976,29.0,Netherlands,0,2,3,5
1948,29.0,Trinidad and Tobago,0,1,0,1
2012,29.0,Kenya,2,4,7,13
1948,29.0,Cuba,0,1,0,1
1948,29.0,Ceylon,0,1,0,1
2000,29.0,Kenya,2,3,2,7
1980,29.0,Mexico,0,1,3,4
1972,29.0,Belgium,0,2,0,2
2004,29.0,Iran,2,2,2,6
2004,29.0,Slovakia,2,2,2,6
1968,29.0,Venezuela,1,0,0,1
1928,29.0,Belgium,0,1,2,3
1996,29.0,Sweden,2,4,2,8
1972,29.0,Greece,0,2,0,2
2016,29.0,South Africa,2,6,2,10
1968,29.0,Pakistan,1,0,0,1
2024,29.0,Denmark,2,2,5,9
1992,29.0,Finland,1,2,2,5
1988,29.0,Portugal,1,0,0,1
1988,29.0,Austria,1,0,0,1
1952,29.0,Netherlands,0,5,0,5
2020,29.0,Belgium,3,1,3,7
1988,29.0,Suriname,1,0,0,1
2008,29.0,Kazakhstan,2,3,4,9
1956,29.0,Argentina,0,1,1,2
1956,29.0,South Korea,0,1,1,2
1964,29.0,Tunisia,0,1,1,2
1952,30.0,Iran,0,3,4,7
1992,30.0,Denmark,1,1,4,6
2020,30.0,Bulgaria,3,1,2,6
1960,30.0,Argentina (ARG),0,1,1,2
1976,30.0,Portugal,0,2,0,2
1976,30.0,Spain,0,2,0,2
1980,30.0,Netherlands,0,1,2,3
2000,30.0,Denmark,2,3,1,6
1984,30.0,Greece,0,1,1,2
1928,30.0,Chile,0,1,0,1
1964,30.0,Cuba,0,1,0,1
1960,30.0,United Arab Republic (RAU),0,1,1,2
2024,30.0,Azerbaijan,2,2,3,7
2016,30.0,Kazakhstan,2,5,10,17
1936,30.0,Australia,0,0,1,1
1936,30.0,Philippines,0,0,1,1
1984,30.0,Puerto Rico,0,1,1,2
1984,30.0,Nigeria,0,1,1,2
1996,30.0,Norway,2,2,3,7
1928,30.0,Haiti,0,1,0,1
1964,30.0,Philippines,0,1,0,1
2024,30.0,Croatia,2,2,3,7
2012,30.0,Denmark,2,4,3,9
2008,30.0,Denmark,2,2,3,7
1964,30.0,Pakistan,0,1,0,1
1936,30.0,Portugal,0,0,1,1
1964,30.0,Argentina,0,1,0,1
2004,31.0,Chinese Taipei,2,2,1,5
1996,31.0,Belgium,2,2,2,6
1952,31.0,Chile,0,2,0,2
1992,31.0,Morocco,1,1,1,3
2012,31.0,Romania,2,4,1,7
2020,31.0,Slovenia,3,1,1,5
1968,31.0,Cuba,0,4,0,4
1972,31.0,Austria,0,1,2,3
1972,31.0,Colombia,0,1,2,3
2008,31.0,North Korea,2,2,2,6
2008,31.0,Thailand,2,2,2,6
1956,31.0,Iceland,0,1,0,1
1956,31.0,Pakistan,0,1,0,1
1980,31.0,Ireland,0,1,1,2
2000,31.0,Finland,2,1,1,4
2016,31.0,Ukraine,2,5,4,11
2024,32.0,Cuba,2,1,6,9
1952,32.0,Lebanon,0,1,1,2
2000,32.0,Austria,2,1,0,3
1976,32.0,Australia,0,1,4,5
1928,32.0,Philippines,0,0,1,1
1960,32.0,Portugal (POR),0,1,0,1
1960,32.0,Singapore (SIN),0,1,0,1
1960,32.0,India (IND),0,1,0,1
1996,32.0,Nigeria,2,1,3,6
1960,32.0,Formosa (ROC),0,1,0,1
1960,32.0,Ghana (GHA),0,1,0,1
2016,32.0,Serbia,2,4,2,8
1960,32.0,Canada (CAN),0,1,0,1
1980,32.0,Uganda,0,1,0,1
1980,32.0,Venezuela,0,1,0,1
1928,32.0,Portugal,0,0,1,1
1960,32.0,Morocco (MAR),0,1,0,1
1952,32.0,Austria,0,1,1,2
2012,32.0,Azerbaijan,2,2,5,9
2020,32.0,Uzbekistan,3,0,2,5
1992,32.0,Ireland,1,1,0,2
1968,32.0,Austria,0,2,2,4
1988,32.0,Sweden,0,4,7,11
2004,32.0,Georgia,2,2,0,4
1948,33.0,Panama,0,0,2,2
1948,33.0,South Korea,0,0,2,2
1972,33.0,Lebanon,0,1,0,1
1972,33.0,Mongolia,0,1,0,1
1972,33.0,Mexico,0,1,0,1
1992,33.0,Ethiopia,1,0,2,3
2024,33.0,Bahrain,2,1,1,4
2012,33.0,Switzerland,2,2,0,4
1972,33.0,Turkey,0,1,0,1
1996,33.0,North Korea,2,1,2,5
1972,33.0,Argentina,0,1,0,1
1972,33.0,Tunisia,0,1,0,1
1976,33.0,Iran,0,1,1,2
1984,33.0,Ireland,0,1,0,1
1984,33.0,Egypt,0,1,0,1
1984,33.0,Colombia,0,1,0,1
1984,33.0,Ivory Coast,0,1,0,1
1984,33.0,Thailand,0,1,0,1
1984,33.0,Syria,0,1,0,1
1984,33.0,Peru,0,1,0,1
1956,33.0,South Africa,0,0,4,4
2008,33.0,Mongolia,2,2,0,4
2020,33.0,Georgia,2,5,1,8
1972,33.0,South Korea,0,1,0,1
2004,33.0,Bulgaria,2,1,9,12
1968,33.0,Switzerland,0,1,4,5
1972,33.0,Pakistan,0,1,0,1
2000,33.0,Lithuania,2,0,3,5
2016,33.0,Poland,2,3,6,11
1988,33.0,Switzerland,0,2,2,4
2000,34.0,Bahamas,2,0,1,3
2000,34.0,Azerbaijan,2,0,1,3
2012,34.0,Norway,2,1,1,4
2020,34.0,Chinese Taipei,2,4,6,12
1976,34.0,Mongolia,0,1,0,1
1976,34.0,Venezuela,0,1,0,1
1980,34.0,Jamaica,0,0,3,3
1996,34.0,Ethiopia,2,0,1,3
1996,34.0,Algeria,2,0,1,3
2008,34.0,Switzerland,2,1,4,7
1952,34.0,Ireland,0,1,0,1
2016,34.0,North Korea,2,3,2,7
1968,34.0,Mongolia,0,1,3,4
1988,34.0,Jamaica,0,2,0,2
2004,34.0,Denmark,2,1,5,8
1964,34.0,Iran,0,0,2,2
1956,34.0,Austria,0,0,2,2
2024,34.0,Slovenia,2,1,0,3
1952,34.0,Spain,0,1,0,1
1952,34.0,Mexico,0,1,0,1
1992,34.0,Algeria,1,0,1,2
1992,34.0,Estonia,1,0,1,2
1992,34.0,Lithuania,1,0,1,2
2016,35.0,Thailand,2,2,2,6
1968,35.0,Brazil,0,1,2,3
1988,35.0,Argentina,0,1,1,2
1964,35.0,Brazil,0,0,1,1
1964,35.0,Ireland,0,0,1,1
2008,35.0,Argentina,2,0,4,6
1964,35.0,Ghana,0,0,1,1
1948,35.0,Ireland,0,0,1,1
1948,35.0,Brazil,0,0,1,1
2012,35.0,Lithuania,2,0,3,5
2020,35.0,Turkey,2,2,9,13
2024,35.0,Chinese Taipei,2,0,5,7
1956,35.0,Switzerland,0,0,1,1
1956,35.0,Uruguay,0,0,1,1
1948,35.0,Iran,0,0,1,1
1980,35.0,Guyana,0,0,1,1
1980,35.0,Lebanon,0,0,1,1
1956,35.0,Bahamas,0,0,1,1
1956,35.0,Greece,0,0,1,1
2004,35.0,Uzbekistan,2,1,2,5
2004,35.0,Jamaica,2,1,2,5
2016,35.0,Belgium,2,2,2,6
1964,35.0,Kenya,0,0,1,1
1964,35.0,Uruguay,0,0,1,1
1948,35.0,Puerto Rico,0,0,1,1
1964,35.0,Nigeria,0,0,1,1
1964,35.0,Mexico,0,0,1,1
1988,36.0,Senegal,0,1,0,1
1988,36.0,Virgin Islands,0,1,0,1
1988,36.0,Netherlands Antilles,0,1,0,1
1988,36.0,Peru,0,1,0,1
1968,36.0,Belgium,0,1,1,2
1988,36.0,Chile,0,1,0,1
2008,36.0,Mexico,2,0,2,4
1968,36.0,South Korea,0,1,1,2
1968,36.0,Uganda,0,1,1,2
2000,36.0,Slovenia,2,0,0,2
2024,36.0,Austria,2,0,3,5
2020,36.0,Uganda,2,1,1,4
2020,36.0,Greece,2,1,1,4
2012,36.0,Tunisia,2,0,1,3
1996,36.0,Great Britain,1,8,6,15
1976,36.0,Brazil,0,0,2,2
1988,36.0,Indonesia,0,1,0,1
1988,36.0,Costa Rica,0,1,0,1
1988,36.0,Iran,0,1,0,1
1952,37.0,South Korea,0,0,2,2
1976,37.0,Bermuda,0,0,1,1
2024,37.0,Hong Kong,2,0,2,4
2024,37.0,Philippines,2,0,2,4
2000,37.0,Switzerland,1,6,2,9
1976,37.0,Puerto Rico,0,0,1,1
1976,37.0,Pakistan,0,0,1,1
1976,37.0,Thailand,0,0,1,1
2004,37.0,Morocco,2,1,0,3
1992,37.0,Switzerland,1,0,0,1
1952,37.0,Trinidad and Tobago,0,0,2,2
1952,37.0,Uruguay,0,0,2,2
1976,37.0,Austria,0,0,1,1
2016,37.0,Slovakia,2,2,0,4
2012,37.0,Sweden,1,4,3,8
2008,37.0,Belgium,2,0,0,2
1996,37.0,Belarus,1,6,8,15
1992,38.0,Jamaica,0,3,1,4
1992,38.0,Nigeria,0,3,1,4
2012,38.0,Colombia,1,3,5,9
2004,38.0,Argentina,2,0,4,6
2000,38.0,Indonesia,1,3,2,6
2016,38.0,Georgia,2,1,4,7
2008,38.0,Zimbabwe,1,3,0,4
2020,38.0,Ecuador,2,1,0,3
1996,38.0,Kenya,1,4,3,8
2020,39.0,Ireland,2,0,2,4
2020,39.0,Israel,2,0,2,4
2024,39.0,Indonesia,2,0,1,3
2000,39.0,Slovakia,1,3,1,5
2024,39.0,Algeria,2,0,1,3
2016,39.0,Azerbaijan,1,7,10,18
2008,39.0,Slovenia,1,2,2,5
1960,39.0,Brazil (BRA),0,0,2,2
1960,39.0,British West Indies (BWI),0,0,2,2
1996,39.0,Jamaica,1,3,2,6
1968,39.0,Cameroon,0,1,0,1
1968,39.0,Jamaica,0,1,0,1
2012,39.0,Mexico,1,3,4,8
2004,39.0,Chile,2,0,1,3
2016,40.0,Belarus,1,4,4,9
1984,40.0,Venezuela,0,0,3,3
1984,40.0,Turkey,0,0,3,3
2008,40.0,Azerbaijan,1,1,4,6
2000,40.0,Mexico,1,2,3,6
1992,40.0,Latvia,0,2,1,3
2008,40.0,Indonesia,1,1,4,6
2012,40.0,Georgia,1,2,3,6
1996,40.0,Finland,1,2,1,4
2004,40.0,Kazakhstan,1,4,3,8
1952,40.0,Portugal,0,0,1,1
1952,40.0,Bulgaria,0,0,1,1
1952,40.0,Egypt,0,0,1,1
1952,40.0,Venezuela,0,0,1,1
2024,41.0,Israel,1,5,1,7
1992,41.0,Austria,0,2,0,2
2020,41.0,Qatar,2,0,1,3
1968,41.0,Argentina,0,0,2,2
1960,41.0,Spain (ESP),0,0,1,1
1960,41.0,Mexico (MEX),0,0,1,1
1960,41.0,Iraq (IRQ),0,0,1,1
2004,41.0,Kenya,1,4,2,7
1960,41.0,Venezuela (VEN),0,0,1,1
2012,41.0,Ireland,1,1,4,6
1996,41.0,FR Yugoslavia,1,1,2,4
1992,41.0,Namibia,0,2,0,2
2000,41.0,Nigeria,1,2,0,3
1972,41.0,Ethiopia,0,0,2,2
1972,41.0,Brazil,0,0,2,2
2016,41.0,Turkey,1,3,4,8
1996,41.0,Indonesia,1,1,2,4
1992,41.0,South Africa,0,2,0,2
2008,42.0,Turkey,1,1,3,5
2008,42.0,Bulgaria,1,1,3,5
2024,42.0,Poland,1,4,5,10
1968,42.0,Greece,0,0,1,1
2004,42.0,Czech Republic,1,3,5,9
1968,42.0,Taiwan,0,0,1,1
2020,42.0,Kosovo,2,0,0,2
2020,42.0,Bahamas,2,0,0,2
2000,42.0,Algeria,1,1,3,5
1984,42.0,Algeria,0,0,2,2
2012,42.0,Serbia,1,1,2,4
2012,42.0,Argentina,1,1,2,4
1968,42.0,India,0,0,1,1
2016,42.0,Armenia,1,3,0,4
2012,42.0,Slovenia,1,1,2,4
2012,42.0,Trinidad and Tobago,1,1,2,4
2024,43.0,Kazakhstan,1,3,3,7
1972,43.0,Niger,0,0,1,1
1972,43.0,Spain,0,0,1,1
1972,43.0,Nigeria,0,0,1,1
1972,43.0,Ghana,0,0,1,1
1972,43.0,India,0,0,1,1
2004,43.0,South Africa,1,3,2,6
2016,43.0,Czech Republic,1,2,7,10
1972,43.0,Jamaica,0,0,1,1
1996,43.0,Iran,1,1,1,3
1996,43.0,Slovakia,1,1,1,3
1984,43.0,Iceland,0,0,1,1
1984,43.0,Cameroon,0,0,1,1
1984,43.0,Chinese Taipei,0,0,1,1
1984,43.0,Dominican Republic,0,0,1,1
2000,43.0,Uzbekistan,1,1,2,4
1984,43.0,Zambia,0,0,1,1
2000,44.0,Latvia,1,1,1,3
2000,44.0,FR Yugoslavia,1,1,1,3
1988,44.0,Belgium,0,0,2,2
1988,44.0,Mexico,0,0,2,2
2024,44.0,Jamaica,1,3,2,6
2024,44.0,Thailand,1,3,2,6
2024,44.0,South Africa,1,3,2,6
2016,44.0,Ethiopia,1,2,5,8
1992,44.0,Independent Olympic Participants,0,1,2,3
1992,44.0,Croatia,0,1,2,3
1992,44.0,Belgium,0,1,2,3
1992,44.0,Iran,0,1,2,3
2008,44.0,Chinese Taipei,1,1,2,4
2008,44.0,Finland,1,1,2,4
2004,44.0,Croatia,1,2,2,5
2020,44.0,Ukraine,1,6,12,19
2016,45.0,Slovenia,1,2,1,4
2004,45.0,Lithuania,1,2,0,3
2020,45.0,Belarus,1,3,3,7
1996,45.0,Croatia,1,1,0,2
1996,45.0,Armenia,1,1,0,2
2020,46.0,Romania,1,3,0,4
1988,46.0,Thailand,0,0,1,1
1988,46.0,Colombia,0,0,1,1
1988,46.0,Greece,0,0,1,1
1988,46.0,Mongolia,0,0,1,1
1988,46.0,Pakistan,0,0,1,1
1988,46.0,Djibouti,0,0,1,1
2020,46.0,Venezuela,1,3,0,4
2000,46.0,New Zealand,1,0,3,4
2012,46.0,Turkey,1,1,1,3
2008,46.0,Latvia,1,1,1,3
2016,46.0,Indonesia,1,2,0,3
1988,46.0,Philippines,0,0,1,1
2004,46.0,Egypt,1,1,3,5
2004,46.0,Switzerland,1,1,3,5
2000,47.0,Estonia,1,0,2,3
2000,47.0,Thailand,1,0,2,3
2008,47.0,Dominican Republic,1,1,0,2
2016,47.0,Romania,1,1,2,4
2008,47.0,Trinidad and Tobago,1,1,0,2
2008,47.0,Estonia,1,1,0,2
2008,47.0,Portugal,1,1,0,2
1996,47.0,Thailand,1,0,1,2
2024,47.0,Ethiopia,1,3,0,4
1996,47.0,Portugal,1,0,1,2
2012,47.0,Dominican Republic,1,1,0,2
1992,48.0,Israel,0,1,1,2
2016,48.0,Bahrain,1,1,0,2
2004,48.0,Indonesia,1,1,2,4
2020,48.0,India,1,2,4,7
2012,48.0,Latvia,1,0,1,2
2024,48.0,Switzerland,1,2,5,8
2012,48.0,Chinese Taipei,1,0,1,2
2016,48.0,Vietnam,1,1,0,2
1996,49.0,Costa Rica,1,0,0,1
1996,49.0,Syria,1,0,0,1
1996,49.0,Ecuador,1,0,0,1
1996,49.0,Hong Kong,1,0,0,1
1996,49.0,Burundi,1,0,0,1
2020,49.0,Hong Kong,1,2,3,6
1992,49.0,Chinese Taipei,0,1,0,1
2000,49.0,Croatia,1,0,1,2
2004,49.0,Zimbabwe,1,1,1,3
1992,49.0,Peru,0,1,0,1
2024,49.0,Ecuador,1,2,2,5
1992,49.0,Mexico,0,1,0,1
2020,50.0,Philippines,1,2,1,4
2000,50.0,Mozambique,1,0,0,1
2000,50.0,Colombia,1,0,0,1
2004,50.0,Azerbaijan,1,0,4,5
2016,50.0,Chinese Taipei,1,0,2,3
2012,50.0,Bahrain,1,0,0,1
2012,50.0,Venezuela,1,0,0,1
2012,50.0,Uganda,1,0,0,1
2012,50.0,Bahamas,1,0,0,1
2012,50.0,Algeria,1,0,0,1
2020,50.0,Slovakia,1,2,1,4
2000,50.0,Cameroon,1,0,0,1
2012,50.0,Grenada,1,0,0,1
2024,50.0,Portugal,1,2,1,4
2016,51.0,Ivory Coast,1,0,1,2
2004,51.0,Belgium,1,0,2,3
2016,51.0,Bahamas,1,0,1,2
2008,51.0,India,1,0,2,3
2024,51.0,Greece,1,1,6,8
2016,51.0,Independent Olympic Athletes[D],1,0,1,2
1992,52.0,Mongolia,0,0,2,2
2008,52.0,Iran,1,0,1,2
2020,52.0,South Africa,1,2,0,3
2024,52.0,Tunisia,1,1,1,3
2024,52.0,Egypt,1,1,1,3
2024,52.0,Argentina,1,1,1,3
2004,52.0,Bahamas,1,0,1,2
2004,52.0,Israel,1,0,1,2
1992,52.0,Slovenia,0,0,2,2
2020,53.0,Austria,1,1,5,7
2000,53.0,Brazil,0,6,6,12
2008,53.0,Cameroon,1,0,0,1
2008,53.0,Panama,1,0,0,1
2008,53.0,Tunisia,1,0,0,1
1996,54.0,Argentina,0,2,1,3
2004,54.0,United Arab Emirates,1,0,0,1
2016,54.0,Singapore,1,0,0,1
1992,54.0,Qatar,0,0,1,1
1992,54.0,Argentina,0,0,1,1
1992,54.0,Thailand,0,0,1,1
1992,54.0,Suriname,0,0,1,1
2016,54.0,Tajikistan,1,0,0,1
2016,54.0,Kosovo,1,0,0,1
2016,54.0,Jordan,1,0,0,1
1992,54.0,Philippines,0,0,1,1
1992,54.0,Ghana,0,0,1,1
1992,54.0,Malaysia,0,0,1,1
1992,54.0,Pakistan,0,0,1,1
1992,54.0,Puerto Rico,0,0,1,1
2004,54.0,Cameroon,1,0,0,1
1992,54.0,Colombia,0,0,1,1
1992,54.0,Bahamas,0,0,1,1
2000,54.0,Jamaica,0,6,3,9
2020,54.0,Egypt,1,1,4,6
2016,54.0,Puerto Rico,1,0,0,1
2016,54.0,Fiji,1,0,0,1
2004,54.0,Dominican Republic,1,0,0,1
2020,55.0,Indonesia,1,1,3,5
2000,55.0,South Africa,0,2,3,5
1996,55.0,Namibia,0,2,0,2
2024,55.0,Chile,1,1,0,2
2024,55.0,Botswana,1,1,0,2
2024,55.0,Saint Lucia,1,1,0,2
1996,55.0,Slovenia,0,2,0,2
2000,55.0,Belgium,0,2,3,5
2024,55.0,Uganda,1,1,0,2
2008,56.0,Sweden,0,4,1,5
2020,56.0,Ethiopia,1,1,2,4
2020,56.0,Portugal,1,1,2,4
2012,56.0,Egypt,0,3,1,4
2012,57.0,India,0,2,4,6
2008,57.0,Lithuania,0,3,2,5
2008,57.0,Nigeria,0,3,2,5
2004,57.0,North Korea,0,4,1,5
1996,57.0,Austria,0,1,2,3
2000,57.0,Argentina,0,2,2,4
2004,58.0,Latvia,0,4,0,4
2020,58.0,Tunisia,1,1,0,2
2000,58.0,Chinese Taipei,0,1,4,5
1996,58.0,Malaysia,0,1,1,2
1996,58.0,Uzbekistan,0,1,1,2
1996,58.0,Moldova,0,1,1,2
2012,58.0,Mongolia,0,2,3,5
2000,58.0,Morocco,0,1,4,5
2004,59.0,Mexico,0,3,1,4
2012,59.0,Thailand,0,2,2,4
2020,59.0,Latvia,1,0,1,2
2008,59.0,Croatia,0,2,3,5
2020,59.0,Fiji,1,0,1,2
2020,59.0,Estonia,1,0,1,2
2024,59.0,Dominican Republic,1,0,2,3
2020,59.0,Thailand,1,0,1,2
2000,60.0,North Korea,0,1,3,4
2024,60.0,Guatemala,1,0,1,2
2016,60.0,Malaysia,0,4,1,5
2004,60.0,Portugal,0,2,1,3
2008,60.0,Greece,0,2,1,3
2024,60.0,Morocco,1,0,1,2
2008,60.0,Colombia,0,2,1,3
2012,60.0,Indonesia,0,2,1,3
2012,60.0,Finland,0,2,1,3
2012,60.0,Bulgaria,0,2,1,3
2000,61.0,Moldova,0,1,1,2
2000,61.0,Saudi Arabia,0,1,1,2
2000,61.0,Trinidad and Tobago,0,1,1,2
2016,61.0,Mexico,0,3,2,5
2004,61.0,Serbia and Montenegro,0,2,0,2
2004,61.0,Finland,0,2,0,2
1996,61.0,Latvia,0,1,0,1
1996,61.0,Azerbaijan,0,1,0,1
1996,61.0,Philippines,0,1,0,1
1996,61.0,Tonga,0,1,0,1
1996,61.0,Zambia,0,1,0,1
1996,61.0,Chinese Taipei,0,1,0,1
1996,61.0,Bahamas,0,1,0,1
2024,62.0,Dominica,1,0,0,1
2016,62.0,Venezuela,0,2,1,3
2024,62.0,Pakistan,1,0,0,1
2008,62.0,Armenia,0,1,4,5
2008,63.0,Uzbekistan,0,1,3,4
2012,63.0,Slovakia,0,1,3,4
2016,63.0,Ireland,0,2,0,2
2020,63.0,Morocco,1,0,0,1
2020,63.0,Bermuda,1,0,0,1
2020,63.0,Puerto Rico,1,0,0,1
2016,63.0,Algeria,0,2,0,2
2004,63.0,Slovenia,0,1,3,4
2008,64.0,Kyrgyzstan,0,1,2,3
2008,64.0,Serbia,0,1,2,3
2000,64.0,Uruguay,0,1,0,1
2008,64.0,Ireland,0,1,2,3
2004,64.0,Estonia,0,1,2,3
2008,64.0,Austria,0,1,2,3
2012,64.0,Belgium,0,1,2,3
2024,64.0,Turkey,0,3,5,8
2000,64.0,Ireland,0,1,0,1
2000,64.0,Sri Lanka,0,1,0,1
2000,64.0,Vietnam,0,1,0,1
2012,65.0,Armenia,0,1,1,2
2012,65.0,Estonia,0,1,1,2
2012,65.0,Malaysia,0,1,1,2
2004,65.0,India,0,1,0,1
2012,65.0,Qatar,0,1,1,2
2012,65.0,Puerto Rico,0,1,1,2
2004,65.0,Hong Kong,0,1,0,1
2004,65.0,Paraguay,0,1,0,1
2024,65.0,Mexico,0,3,2,5
2016,65.0,Lithuania,0,1,3,4
2016,66.0,Bulgaria,0,1,2,3
2020,66.0,Colombia,0,4,1,5
2024,66.0,Armenia,0,3,1,4
2024,66.0,Colombia,0,3,1,4
2020,67.0,Azerbaijan,0,3,4,7
2016,67.0,India,0,1,1,2
2016,67.0,Mongolia,0,1,1,2
2008,68.0,Morocco,0,1,1,2
2004,68.0,Venezuela,0,0,2,2
2024,68.0,Kyrgyzstan,0,2,4,6
1996,68.0,Georgia,0,0,2,2
1996,68.0,Morocco,0,0,2,2
2008,68.0,Bahamas,0,1,1,2
2024,68.0,North Korea,0,2,4,6
2000,68.0,Georgia,0,0,6,6
2020,68.0,Dominican Republic,0,3,2,5
1996,68.0,Trinidad and Tobago,0,0,2,2
2004,68.0,Colombia,0,0,2,2
2004,68.0,Nigeria,0,0,2,2
2008,68.0,Tajikistan,0,1,1,2
2008,68.0,Algeria,0,1,1,2
2000,69.0,Portugal,0,0,2,2
2020,69.0,Armenia,0,2,2,4
2000,69.0,Costa Rica,0,0,2,2
2016,69.0,Niger,0,1,0,1
2016,69.0,Qatar,0,1,0,1
2016,69.0,Grenada,0,1,0,1
2016,69.0,Burundi,0,1,0,1
2016,69.0,Philippines,0,1,0,1
2012,70.0,Botswana,0,1,0,1
2012,70.0,Montenegro,0,1,0,1
2012,70.0,Portugal,0,1,0,1
2020,70.0,Kyrgyzstan,0,2,1,3
2024,70.0,Lithuania,0,2,2,4
2012,70.0,Gabon,0,1,0,1
2012,70.0,Cyprus,0,1,0,1
2012,70.0,Guatemala,0,1,0,1
2004,71.0,Syria,0,0,1,1
2000,71.0,Israel,0,0,1,1
2000,71.0,India,0,0,1,1
2004,71.0,Mongolia,0,0,1,1
2004,71.0,Eritrea,0,0,1,1
2000,71.0,Armenia,0,0,1,1
2000,71.0,Barbados,0,0,1,1
2020,71.0,Mongolia,0,1,3,4
2004,71.0,Trinidad and Tobago,0,0,1,1
2000,71.0,Chile,0,0,1,1
2000,71.0,Iceland,0,0,1,1
2000,71.0,Qatar,0,0,1,1
2000,71.0,Macedonia,0,0,1,1
1996,71.0,Tunisia,0,0,1,1
1996,71.0,Uganda,0,0,1,1
1996,71.0,Mozambique,0,0,1,1
1996,71.0,Puerto Rico,0,0,1,1
2024,71.0,India,0,1,5,6
1996,71.0,India,0,0,1,1
1996,71.0,Israel,0,0,1,1
1996,71.0,Lithuania,0,0,1,1
2000,71.0,Kuwait,0,0,1,1
2000,71.0,Kyrgyzstan,0,0,1,1
1996,71.0,Mongolia,0,0,1,1
1996,71.0,Mexico,0,0,1,1
2020,72.0,San Marino,0,1,2,3
2020,72.0,Argentina,0,1,2,3
2024,72.0,Moldova,0,1,3,4
2008,72.0,Vietnam,0,1,0,1
2008,72.0,Samoa,0,1,0,1
2008,72.0,Singapore,0,1,0,1
2008,72.0,South Africa,0,1,0,1
2008,72.0,Sudan,0,1,0,1
2008,72.0,Malaysia,0,1,0,1
2008,72.0,Iceland,0,1,0,1
2008,72.0,Ecuador,0,1,0,1
2008,72.0,Chile,0,1,0,1
2024,73.0,Kosovo,0,1,1,2
2024,74.0,Cyprus,0,1,0,1
2020,74.0,Malaysia,0,1,1,2
2020,74.0,Nigeria,0,1,1,2
2024,74.0,Fiji,0,1,0,1
2024,74.0,Panama,0,1,0,1
2024,74.0,Jordan,0,1,0,1
2024,74.0,Mongolia,0,1,0,1
2020,74.0,Jordan,0,1,1,2
2016,74.0,Norway,0,0,4,4
2016,75.0,Tunisia,0,0,3,3
2016,75.0,Egypt,0,0,3,3
2012,76.0,Uzbekistan,0,0,3,3
2012,77.0,Greece,0,0,2,2
2016,77.0,Israel,0,0,2,2
2020,77.0,Namibia,0,1,0,1
2012,77.0,Singapore,0,0,2,2
2020,77.0,Bahrain,0,1,0,1
2020,77.0,Lithuania,0,1,0,1
2020,77.0,Saudi Arabia,0,1,0,1
2020,77.0,North Macedonia,0,1,0,1
2020,77.0,Turkmenistan,0,1,0,1
2016,78.0,Nigeria,0,0,1,1
2016,78.0,Portugal,0,0,1,1
2016,78.0,Austria,0,0,1,1
2016,78.0,Estonia,0,0,1,1
2016,78.0,Trinidad and Tobago,0,0,1,1
2016,78.0,United Arab Emirates,0,0,1,1
2016,78.0,Dominican Republic,0,0,1,1
2016,78.0,Morocco,0,0,1,1
2016,78.0,Finland,0,0,1,1
2024,79.0,Tajikistan,0,0,3,3
2012,79.0,Tajikistan,0,0,1,1
2012,79.0,Vietnam,0,0,1,1
2012,79.0,Morocco,0,0,1,1
2012,79.0,Saudi Arabia,0,0,1,1
2012,79.0,Kuwait,0,0,1,1
2012,79.0,Hong Kong,0,0,1,1
2012,79.0,Afghanistan,0,0,1,1
2012,79.0,Cameroon,0,0,1,1
2024,80.0,Malaysia,0,0,2,2
2024,80.0,Puerto Rico,0,0,2,2
2024,80.0,Albania,0,0,2,2
2024,80.0,Grenada,0,0,2,2
2008,81.0,Egypt,0,0,2,2
2008,82.0,Venezuela,0,0,1,1
2008,82.0,Moldova,0,0,1,1
2008,82.0,Mauritius,0,0,1,1
2008,82.0,Israel,0,0,1,1
2008,82.0,Afghanistan,0,0,1,1
2008,82.0,Togo,0,0,1,1
2020,83.0,Kazakhstan,0,0,8,8
2024,84.0,Singapore,0,0,1,1
2020,84.0,Mexico,0,0,4,4
2024,84.0,Cape Verde,0,0,1,1
2024,84.0,Ivory Coast,0,0,1,1
2024,84.0,Zambia,0,0,1,1
2024,84.0,Refugee Olympic Team,0,0,1,1
2024,84.0,Peru,0,0,1,1
2024,84.0,Qatar,0,0,1,1
2024,84.0,Slovakia,0,0,1,1
2020,85.0,Finland,0,0,2,2
2020,86.0,Botswana,0,0,1,1
2020,86.0,Syria,0,0,1,1
2020,86.0,Moldova,0,0,1,1
2020,86.0,Kuwait,0,0,1,1
2020,86.0,Ivory Coast,0,0,1,1
2020,86.0,Grenada,0,0,1,1
2020,86.0,Ghana,0,0,1,1
2020,86.0,Burkina Faso,0,0,1,1
